Country,Confirmed,Deaths,Recovered,Active,New Cases,Deaths / 100 Cases,Recovered / 100 Cases,Deaths / 100 Recovered,Population,Cases / Million People,Confirmed last week,1 week change,1 week % increase
Afghanistan,154585,7199,0,147386,98,4.66,0.0,0.0,38928341,3971.0,154094,491,0.32
Albania,163404,2587,0,160817,451,1.58,0.0,0.0,2877800,56781.0,157436,5968,3.79
Algeria,201766,5709,0,196057,166,2.83,0.0,0.0,43851043,4601.0,200301,1465,0.73
Andorra,15140,130,0,15010,16,0.86,0.0,0.0,77265,195949.0,15096,44,0.29
Angola,52644,1409,0,51235,337,2.68,0.0,0.0,32866268,1602.0,50738,1906,3.76
Antigua and Barbuda,2603,55,0,2548,0,2.11,0.0,0.0,97928,26581.0,2297,306,13.32
Argentina,5241394,114518,0,5126876,2162,2.18,0.0,0.0,45195777,115971.0,5226831,14563,0.28
Armenia,253942,5143,0,248799,342,2.03,0.0,0.0,2963234,85698.0,249146,4796,1.92
Australia,88710,1178,0,87532,1582,1.33,0.0,0.0,50919400,1742.0,76901,11809,15.36
Austria,725434,10896,0,714538,1399,1.5,0.0,0.0,9006400,80547.0,711573,13861,1.95
Azerbaijan,473459,6327,0,467132,6286,1.34,0.0,0.0,10139175,46696.0,461249,12210,2.65
Bahamas,20215,510,0,19705,185,2.52,0.0,0.0,393248,51405.0,19601,614,3.13
Bahrain,274383,1388,0,272995,119,0.51,0.0,0.0,1701583,161252.0,273835,548,0.2
Bangladesh,1544238,27251,0,1516987,1555,1.76,0.0,0.0,164689383,9377.0,1532366,11872,0.77
Barbados,6631,59,0,6572,104,0.89,0.0,0.0,287371,23075.0,5984,647,10.81
Belarus,518369,4016,0,514353,1941,0.77,0.0,0.0,9449321,54858.0,504961,13408,2.66
Belgium,1224885,25517,0,1199368,5071,2.08,0.0,0.0,23021022,53207.0,1210381,14504,1.2
Belize,18902,395,0,18507,370,2.09,0.0,0.0,397621,47538.0,17767,1135,6.39
Benin,21450,146,0,21304,0,0.68,0.0,0.0,12123198,1769.0,19841,1609,8.11
Bhutan,2597,3,0,2594,0,0.12,0.0,0.0,771612,3366.0,2596,1,0.04
Bolivia,497386,18664,0,478722,286,3.75,0.0,0.0,11673029,42610.0,495035,2351,0.47
Bosnia and Herzegovina,227579,10287,0,217292,1722,4.52,0.0,0.0,3280815,69367.0,222161,5418,2.44
Botswana,173788,2354,0,171434,1536,1.35,0.0,0.0,2351625,73901.0,165644,8144,4.92
Brazil,21247667,590955,0,20656712,7884,2.78,0.0,0.0,422706534,50266.0,21006424,241243,1.15
Brunei,5261,28,0,5233,214,0.53,0.0,0.0,437483,12026.0,4323,938,21.7
Bulgaria,484546,20166,0,464380,2360,4.16,0.0,0.0,6948445,69734.0,473270,11276,2.38
Burkina Faso,14052,172,0,13880,11,1.22,0.0,0.0,20903278,672.0,13950,102,0.73
Burma,448158,17129,0,431029,1585,3.82,0.0,0.0,54409800,8237.0,434106,14052,3.24
Burundi,14189,38,0,14151,0,0.27,0.0,0.0,11890781,1193.0,14189,0,0.0
Cabo Verde,37157,331,0,36826,49,0.89,0.0,0.0,555988,66831.0,36640,517,1.41
Cambodia,104716,2123,0,102593,622,2.03,0.0,0.0,16718971,6263.0,100133,4583,4.58
Cameroon,85414,1368,0,84046,0,1.6,0.0,0.0,26545864,3218.0,84210,1204,1.43
Canada,1589989,27487,0,1562502,8986,1.73,0.0,0.0,75750184,20990.0,1559129,30860,1.98
Central African Republic,11340,100,0,11240,31,0.88,0.0,0.0,4829764,2348.0,11309,31,0.27
Chad,5029,174,0,4855,0,3.46,0.0,0.0,16425859,306.0,5017,12,0.24
Chile,1647746,37367,0,1610379,277,2.27,0.0,0.0,36692988,44906.0,1644540,3206,0.19
China,108038,4849,0,103189,77,4.49,0.0,0.0,2809352660,38.0,107549,489,0.45
Colombia,4942249,125924,0,4816325,1185,2.55,0.0,0.0,99141018,49851.0,4931563,10686,0.22
Comoros,4109,147,0,3962,3,3.58,0.0,0.0,869595,4725.0,4100,9,0.22
Congo (Brazzaville),13701,183,0,13518,0,1.34,0.0,0.0,89561403,153.0,13701,0,0.0
Congo (Kinshasa),56463,1068,0,55395,76,1.89,0.0,0.0,5518087,10232.0,56215,248,0.44
Costa Rica,510653,6056,0,504597,5490,1.19,0.0,0.0,5094114,100244.0,489784,20869,4.26
Cote d'Ivoire,59153,569,0,58584,133,0.96,0.0,0.0,26378274,2242.0,58148,1005,1.73
Croatia,392248,8514,0,383734,264,2.17,0.0,0.0,4105268,95547.0,384082,8166,2.13
Cuba,809911,6856,0,803055,8544,0.85,0.0,0.0,11326616,71505.0,753544,56367,7.48
Cyprus,117235,547,0,116688,741,0.47,0.0,0.0,1207361,97100.0,116368,867,0.75
Czechia,1686364,30431,0,1655933,182,1.8,0.0,0.0,10708981,157472.0,1683315,3049,0.18
Denmark,356452,2632,0,353820,276,0.74,0.0,0.0,5897840,60438.0,354068,2384,0.67
Diamond Princess,712,13,0,699,0,1.83,0.0,0.0,0,42269.203125,712,0,0.0
Djibouti,12085,159,0,11926,45,1.32,0.0,0.0,988002,12232.0,11873,212,1.79
Dominica,2908,10,0,2898,150,0.34,0.0,0.0,71991,40394.0,2280,628,27.54
Dominican Republic,355378,4029,0,351349,228,1.13,0.0,0.0,10847904,32760.0,353542,1836,0.52
Ecuador,507020,32666,0,474354,17,6.44,0.0,0.0,17643060,28738.0,505278,1742,0.34
Egypt,297608,16992,0,280616,679,5.71,0.0,0.0,102334403,2908.0,293448,4160,1.42
El Salvador,102024,3114,0,98910,2323,3.05,0.0,0.0,6486201,15729.0,99701,2323,2.33
Equatorial Guinea,11063,137,0,10926,0,1.24,0.0,0.0,1402985,7885.0,10498,565,5.38
Eritrea,6674,40,0,6634,3,0.6,0.0,0.0,3546427,1882.0,6657,17,0.26
Estonia,150142,1328,0,148814,366,0.88,0.0,0.0,1326539,113183.0,146884,3258,2.22
Eswatini,45395,1200,0,44195,15,2.64,0.0,0.0,1160164,39128.0,44976,419,0.93
Ethiopia,333698,5164,0,328534,737,1.55,0.0,0.0,114963583,2903.0,323715,9983,3.08
Fiji,49959,566,0,49393,0,1.13,0.0,0.0,896444,55730.0,49113,846,1.72
Finland,136257,1057,0,135200,0,0.78,0.0,0.0,5540718,24592.0,133851,2406,1.8
France,7045422,116765,0,6928657,1547,1.66,0.0,0.0,68151730,103378.0,6992980,52442,0.75
Gabon,28120,176,0,27944,477,0.63,0.0,0.0,2225728,12634.0,26903,1217,4.52
Gambia,9888,332,0,9556,0,3.36,0.0,0.0,2416664,4092.0,9848,40,0.41
Georgia,595926,8575,0,587351,662,1.44,0.0,0.0,3989175,149386.0,581815,14111,2.43
Germany,4155160,93058,0,4062102,5328,2.24,0.0,0.0,166803158,24911.0,4093412,61748,1.51
Ghana,125565,1125,0,124440,304,0.9,0.0,0.0,31072945,4041.0,123874,1691,1.37
Greece,632908,14505,0,618403,2124,2.29,0.0,0.0,10423056,60722.0,616765,16143,2.62
Grenada,4077,55,0,4022,236,1.35,0.0,0.0,112519,36234.0,2386,1691,70.87
Guatemala,530026,13061,0,516965,604,2.46,0.0,0.0,17915567,29585.0,511457,18569,3.63
Guinea,30271,375,0,29896,135,1.24,0.0,0.0,13132792,2305.0,30047,224,0.75
Guinea-Bissau,6080,130,0,5950,0,2.14,0.0,0.0,1967998,3089.0,6022,58,0.96
Guyana,29683,733,0,28950,130,2.47,0.0,0.0,786559,37738.0,28099,1584,5.64
Haiti,21368,603,0,20765,38,2.82,0.0,0.0,11402533,1874.0,21178,190,0.9
Holy See,27,0,0,27,0,0.0,0.0,0.0,809,33375.0,27,0,0.0
Honduras,359768,9537,0,350231,2114,2.65,0.0,0.0,9904608,36323.0,353641,6127,1.73
Hungary,818231,30136,0,788095,1072,3.68,0.0,0.0,9660350,84700.0,815605,2626,0.32
Iceland,11471,33,0,11438,67,0.29,0.0,0.0,341250,33615.0,11279,192,1.7
India,33504534,445385,0,33059149,26115,1.33,0.0,0.0,2751341248,12178.0,33289579,214955,0.65
Indonesia,4192695,140634,0,4052061,1932,3.35,0.0,0.0,273523621,15328.0,4170088,22607,0.54
Iran,5442232,117526,0,5324706,17397,2.16,0.0,0.0,83992953,64794.0,5318327,123905,2.33
Iraq,1978412,21869,0,1956543,3192,1.11,0.0,0.0,40222503,49187.0,1954969,23443,1.2
Ireland,376517,5179,0,371338,1150,1.38,0.0,0.0,4937796,76252.0,367536,8981,2.44
Israel,1235064,7555,0,1227509,6935,0.61,0.0,0.0,8655541,142691.0,1184053,51011,4.31
Italy,4638516,130354,0,4508162,2405,2.81,0.0,0.0,120822834,38391.0,4609205,29311,0.64
Jamaica,80406,1794,0,78612,733,2.23,0.0,0.0,2961161,27154.0,76451,3955,5.17
Japan,1680328,17247,0,1663081,2236,1.03,0.0,0.0,252643406,6651.0,1646128,34200,2.08
Jordan,813601,10616,0,802985,0,1.3,0.0,0.0,10203140,79740.0,807384,6217,0.77
Kazakhstan,939065,15503,0,923562,2111,1.65,0.0,0.0,18776707,50012.0,918208,20857,2.27
Kenya,246643,4995,0,241648,113,2.03,0.0,0.0,53771300,4587.0,243929,2714,1.11
Kiribati,2,0,0,2,0,0.0,0.0,0.0,117606,17.0,2,0,0.0
"Korea, South",289263,2413,0,286850,1727,0.83,0.0,0.0,51269183,5642.0,275910,13353,4.84
Kosovo,159155,2905,0,156250,48,1.83,0.0,0.0,1793000,88765.0,157261,1894,1.2
Kuwait,411233,2440,0,408793,53,0.59,0.0,0.0,4270563,96295.0,410842,391,0.1
Kyrgyzstan,177780,2590,0,175190,58,1.46,0.0,0.0,6524191,27249.0,177226,554,0.31
Laos,19399,16,0,19383,214,0.08,0.0,0.0,7275556,2666.0,17555,1844,10.5
Latvia,150749,2645,0,148104,189,1.75,0.0,0.0,1886202,79922.0,147328,3421,2.32
Lebanon,618580,8240,0,610340,302,1.33,0.0,0.0,6825442,90629.0,613982,4598,0.75
Lesotho,14395,403,0,13992,0,2.8,0.0,0.0,2142252,6720.0,14395,0,0.0
Liberia,5915,283,0,5632,11,4.78,0.0,0.0,5057677,1170.0,5727,188,3.28
Libya,332026,4517,0,327509,1081,1.36,0.0,0.0,6871287,48321.0,325221,6805,2.09
Liechtenstein,3419,60,0,3359,14,1.75,0.0,0.0,38137,89650.0,3386,33,0.97
Lithuania,316695,4810,0,311885,746,1.52,0.0,0.0,2722291,116334.0,308956,7739,2.5
Luxembourg,77340,834,0,76506,151,1.08,0.0,0.0,625976,123551.0,76798,542,0.71
MS Zaandam,9,2,0,7,0,22.22,0.0,0.0,0,42269.203125,9,0,0.0
Madagascar,42898,958,0,41940,0,2.23,0.0,0.0,27691019,1549.0,42898,0,0.0
Malawi,61382,2264,0,59118,19,3.69,0.0,0.0,19129955,3209.0,61137,245,0.4
Malaysia,2112175,23744,0,2088431,14345,1.12,0.0,0.0,64998698,32496.0,1995771,116404,5.83
Maldives,83655,229,0,83426,79,0.27,0.0,0.0,540542,154761.0,82950,705,0.85
Mali,15074,545,0,14529,6,3.62,0.0,0.0,20250834,744.0,14984,90,0.6
Malta,36994,455,0,36539,22,1.23,0.0,0.0,441539,83784.0,36793,201,0.55
Marshall Islands,4,0,0,4,0,0.0,0.0,0.0,58413,68.0,4,0,0.0
Mauritania,35515,766,0,34749,53,2.16,0.0,0.0,4649660,7638.0,34950,565,1.62
Mauritius,14735,59,0,14676,492,0.4,0.0,0.0,1271767,11586.0,13289,1446,10.88
Mexico,3573044,271765,0,3301279,3367,7.61,0.0,0.0,255584572,13980.0,3516043,57001,1.62
Micronesia,1,0,0,1,0,0.0,0.0,0.0,113815,9.0,1,0,0.0
Moldova,282650,6605,0,276045,950,2.34,0.0,0.0,4033963,70068.0,275558,7092,2.57
Monaco,3290,33,0,3257,0,1.0,0.0,0.0,39244,83834.0,3281,9,0.27
Mongolia,277997,1119,0,276878,0,0.4,0.0,0.0,3278292,84799.0,257770,20227,7.85
Montenegro,126684,1859,0,124825,425,1.47,0.0,0.0,628062,201706.0,122364,4320,3.53
Morocco,920374,13958,0,906416,693,1.52,0.0,0.0,36910558,24935.0,905564,14810,1.64
Mozambique,150067,1903,0,148164,49,1.27,0.0,0.0,31255435,4801.0,149259,808,0.54
Namibia,126900,3471,0,123429,89,2.74,0.0,0.0,2540916,49943.0,126341,559,0.44
Nepal,785541,11048,0,774493,975,1.41,0.0,0.0,29136808,26960.0,778312,7229,0.93
Netherlands,2023692,18518,0,2005174,1409,0.92,0.0,0.0,34882427,58015.0,2009417,14275,0.71
New Zealand,4096,27,0,4069,13,0.66,0.0,0.0,4839692,846.0,3967,129,3.25
Nicaragua,13025,202,0,12823,0,1.55,0.0,0.0,6624554,1966.0,12350,675,5.47
Niger,5964,201,0,5763,7,3.37,0.0,0.0,24206636,246.0,5929,35,0.59
Nigeria,202191,2661,0,199530,393,1.32,0.0,0.0,399640130,506.0,199538,2653,1.33
North Macedonia,187068,6472,0,180596,154,3.46,0.0,0.0,2083380,89791.0,183705,3363,1.83
Norway,182918,841,0,182077,679,0.46,0.0,0.0,5421242,33741.0,177262,5656,3.19
Oman,303459,4093,0,299366,36,1.35,0.0,0.0,5106622,59425.0,303163,296,0.1
Pakistan,1227905,27327,0,1200578,1897,2.23,0.0,0.0,428724125,2864.0,1210082,17823,1.47
Palau,5,0,0,5,0,0.0,0.0,0.0,18008,278.0,2,3,150.0
Panama,464440,7176,0,457264,152,1.55,0.0,0.0,4314768,107640.0,462224,2216,0.48
Papua New Guinea,18968,212,0,18756,426,1.12,0.0,0.0,8947027,2120.0,18412,556,3.02
Paraguay,459665,16132,0,443533,43,3.51,0.0,0.0,7132530,64446.0,459340,325,0.07
Peru,2167652,199036,0,1968616,644,9.18,0.0,0.0,65597846,33045.0,2161358,6294,0.29
Philippines,2385616,36934,0,2348682,18867,1.55,0.0,0.0,109581085,21770.0,2248071,137545,6.12
Poland,2898299,75488,0,2822811,364,2.6,0.0,0.0,76257753,38007.0,2893919,4380,0.15
Portugal,1062320,17914,0,1044406,272,1.69,0.0,0.0,10196707,104183.0,1056042,6278,0.59
Qatar,235626,604,0,235022,139,0.26,0.0,0.0,2881060,81784.0,234773,853,0.36
Romania,1152052,35592,0,1116460,3342,3.09,0.0,0.0,19237682,59885.0,1122653,29399,2.62
Russia,7189445,195438,0,6994007,19376,2.72,0.0,0.0,292579178,24573.0,7055296,134149,1.9
Rwanda,95503,1215,0,94288,246,1.27,0.0,0.0,12952209,7373.0,93079,2424,2.6
Saint Kitts and Nevis,1680,10,0,1670,48,0.6,0.0,0.0,53109,31633.0,1476,204,13.82
Saint Lucia,10605,150,0,10455,85,1.41,0.0,0.0,183629,57752.0,9823,782,7.96
Saint Vincent and the Grenadines,2830,14,0,2816,39,0.49,0.0,0.0,110854,25529.0,2487,343,13.79
Samoa,3,0,0,3,0,0.0,0.0,0.0,196130,15.0,3,0,0.0
San Marino,5419,90,0,5329,7,1.66,0.0,0.0,33938,159674.0,5388,31,0.58
Sao Tome and Principe,3097,45,0,3052,54,1.45,0.0,0.0,219159,14131.0,2825,272,9.63
Saudi Arabia,546612,8667,0,537945,201,1.59,0.0,0.0,34813867,15701.0,545829,783,0.14
Senegal,73654,1845,0,71809,9,2.5,0.0,0.0,16743930,4399.0,73500,154,0.21
Serbia,872110,7808,0,864302,6424,0.9,0.0,0.0,8737370,99814.0,823161,48949,5.95
Seychelles,20961,106,0,20855,368,0.51,0.0,0.0,98340,213148.0,20593,368,1.79
Sierra Leone,6392,121,0,6271,0,1.89,0.0,0.0,7976985,801.0,6385,7,0.11
Singapore,77804,60,0,77744,0,0.08,0.0,0.0,5850343,13299.0,72294,5510,7.62
Slovakia,402922,12573,0,390349,114,3.12,0.0,0.0,5459643,73800.0,398744,4178,1.05
Slovenia,283770,4503,0,279267,291,1.59,0.0,0.0,2078932,136498.0,276457,7313,2.65
Solomon Islands,20,0,0,20,0,0.0,0.0,0.0,652858,31.0,20,0,0.0
Somalia,19235,1079,0,18156,231,5.61,0.0,0.0,15893219,1210.0,18568,667,3.59
South Africa,2884134,86216,0,2797918,1504,2.99,0.0,0.0,59308690,48629.0,2860835,23299,0.81
South Sudan,11831,121,0,11710,17,1.02,0.0,0.0,11193729,1057.0,11623,208,1.79
Spain,4935534,85901,0,4849633,5988,1.74,0.0,0.0,93691843,52678.0,4915265,20269,0.41
Sri Lanka,506009,12218,0,493791,1518,2.41,0.0,0.0,21413250,23631.0,488482,17527,3.59
Sudan,38041,2879,0,35162,46,7.57,0.0,0.0,43849269,868.0,37951,90,0.24
Summer Olympics 2020,865,0,0,865,0,0.0,0.0,0.0,0,42269.203125,865,0,0.0
Suriname,37590,814,0,36776,844,2.17,0.0,0.0,586634,64077.0,33988,3602,10.6
Sweden,1144982,14775,0,1130207,0,1.29,0.0,0.0,20426859,56053.0,1138017,6965,0.61
Switzerland,827111,11015,0,816096,4033,1.33,0.0,0.0,8654618,95569.0,814118,12993,1.6
Syria,30913,2136,0,28777,204,6.91,0.0,0.0,17500657,1766.0,29648,1265,4.27
Taiwan*,16147,840,0,15307,6,5.2,0.0,0.0,23806638,678.0,16093,54,0.34
Tajikistan,17484,125,0,17359,0,0.71,0.0,0.0,9537642,1833.0,17484,0,0.0
Tanzania,1367,50,0,1317,0,3.66,0.0,0.0,59734213,23.0,1367,0,0.0
Thailand,1489186,15469,0,1473717,12709,1.04,0.0,0.0,69799978,21335.0,1394756,94430,6.77
Timor-Leste,19058,105,0,18953,25,0.55,0.0,0.0,1318442,14455.0,18597,461,2.48
Togo,24655,215,0,24440,56,0.87,0.0,0.0,8278737,2978.0,23778,877,3.69
Trinidad and Tobago,48523,1416,0,47107,0,2.92,0.0,0.0,1399491,34672.0,47208,1315,2.79
Tunisia,700400,24527,0,675873,472,3.5,0.0,0.0,11818618,59262.0,685799,14601,2.13
Turkey,6874917,61805,0,6813112,27688,0.9,0.0,0.0,84339067,81515.0,6682834,192083,2.87
US,42289819,676076,0,41613743,201648,1.6,0.0,0.0,330541757,127941.0,41317328,972491,2.35
Uganda,122277,3129,0,119148,65,2.56,0.0,0.0,45741000,2673.0,121587,690,0.57
Ukraine,2455873,58477,0,2397396,2633,2.38,0.0,0.0,89634808,27399.0,2420776,35097,1.45
United Arab Emirates,733003,2077,0,730926,313,0.28,0.0,0.0,9890400,74113.0,729518,3485,0.48
United Kingdom,7500734,135589,0,7365145,35943,1.81,0.0,0.0,134862019,55618.0,7290168,210566,2.89
Uruguay,387744,6048,0,381696,117,1.56,0.0,0.0,3473727,111622.0,386873,871,0.23
Uzbekistan,168938,1192,0,167746,501,0.71,0.0,0.0,33469199,5048.0,164890,4048,2.45
Vanuatu,4,1,0,3,0,25.0,0.0,0.0,292680,14.0,4,0,0.0
Venezuela,356262,4311,0,351951,2023,1.21,0.0,0.0,28435943,12529.0,347647,8615,2.48
Vietnam,695744,17305,0,678439,8681,2.49,0.0,0.0,97338583,7148.0,624547,71197,11.4
West Bank and Gaza,386493,3935,0,382558,2103,1.02,0.0,0.0,4543126,85072.0,372108,14385,3.87
Yemen,8718,1649,0,7069,51,18.91,0.0,0.0,29825968,292.0,8452,266,3.15
Zambia,208502,3639,0,204863,33,1.75,0.0,0.0,18383956,11342.0,207960,542,0.26
Zimbabwe,128186,4569,0,123617,248,3.56,0.0,0.0,14862927,8625.0,126399,1787,1.41
